ParticipantID;TotalNumberOfAddActions;TotalNumberOfTotalChangeActions;TotalNumberOfManualChangeActions;TotalNumberOfAutomatedChangeActions;TotalNumberOfRemoveActions
1;19;5;3;2;1
2;20;10;1;9;1
3;39;14;9;5;2
4;9;3;0;3;0
5;15;2;1;1;1
6;24;4;2;2;1
7;20;9;3;6;1
8;25;14;4;10;1
9;28;7;2;5;2
10;13;6;1;5;1
11;46;19;4;15;1
12;24;7;2;5;2
13;48;28;10;18;7
